NO ./textures/1.xpm
SO ./textures/2.xpm
WE ./textures/3.xpm
EA ./textures/4.xpm

F 73,94,75
C 101,136,151


111111111111111111111111111
100000000000001000000000001
100000000000000100000000001
111110000S00000010000000001
100000000000000001000000001
100000000000000000100000001
100000000000000000010000001
111111111000000000001000001
100000000000000000000100001
100000000000010000000010001
100000000000100000000001001
100000000001000000000000101
111111111111111111111111111
