NO ./textures/1.xpm
SO ./textures/2.xpm
WE ./textures/3.xpm
EA ./textures/4.xpm

F 73,94,75
C 101,136,151

11111111111111111111111111111111111111111111111111111111
10E00000000000000000000000000000000000000000000000000001
10111111101111111111111111111100000001111111111101100001
10000000000000000000000000000000000000000000000000000001
11111101011101111111000011111111000000001111101000100001
10000000000000000000000000000000000000000000000000000001
10000111111111111111111111000111111110001111110010110001
10000000000000000000000000000000000000000000000000000001
10000000000000000000000000000000000000000000000000000001
10000000000000000000000000000000000000000000000000000001
10000000000000000000000000000000000000000000000000000001
10000000000000000000000000000000000000000000000000000001
10000000000000000000000000000000000000000000000000000001
10000000000000000000000000000000000000000000000000000001
10111111101111111111111111111100000001111111111101100001
10000000000000000000000000000000000000000000000000000001
11111101011101111111000011111111000000001111101000100001
10000000000000000000000000000000000000000000000000000001
10000111111111111111111110001111111100011111100101100111
10000000000000000000000000000000000000000000000000000001
11111111111000011000001111111101111100000011101000101001
10000000000000000000000000000000000000000000000000000001
11111111111111111111111111111111111111111111111111111111

